12 9
o o o o o o o o o o o o
o x x x o o o x x x o o
o x o o o o o o o x o o
o x o o x o x o o x o o
o o o o x o x o o o o o
o x o o x x x o o x o o
o x o o o o o o o x o o
o x x x o o o x x x o o
o o o o o o o o o o o o