9 5
o o x o o o x o o
o o x o x o x o o
o o x o x o x o o
o o x o x o x o o
o o o o x o o o o